1111111111111
10010100000C1
1000011111001
1PC011E00C001
1111111111111