1111111111111111111111111111111111111111
1E0000000000000C00000C000000000000000001
1010010100100000101001000000010101010101
1010010010101010001001000000010101010101
1P0000000C00C0000000000000000000C0000001
1000000000000000100000100000100000000001
1010101010101010101010101010101010101011
1000000C00000000000000000000000000000001
1000000101010101010101010101001010101011
1010010100000000000000000000100000000001
101001000000C000000000000000100101010001
1010010101010101010101010101010101010101
1000000000000000000000000000000000000C01
1111111111111111111111111111111111111111
