1111111111111
1P0011E000C00
1111111111111